18 19          $
...................
.#################.
.#@....#.....1...#.
.#.##.#.###.##.#.#.
.#....#...#....#.#.
.####.###.#.####.#.
.#....#...#....#.#.
.#.######.#.##.#.#.
.#......#.#....#.#.
.###.####.#.####.#.
.#..3....#.#..2#.#.
.#.######.#.##.#.#.
.#....#...#....#.#.
.####.#.###.####.#.
.#....#...#....#.#.
.#..&......#...#.#.
.#################.
...................
