79 181         $
))))))))))))))))))))))))))))))))))))))))))))))))))))))))))))))))))))))))))))))))))))#            !)))))))))))))))))))))))))))))))))))))))))))))))))))))))))))))))))))))))))))))))))))
))))))))))))))))))))))))))))))))))))))))))))))))))!"""""""""""""""""""""""""""""""""=            ;""""""""""""""""""""""""""""""""#))))))))))))))))))))))))))))))))))))))))))))))))))
)))))))))))))))))))))))))))))))))))))))))))))))))),                                                                               -))))))))))))))))))))))))))))))))))))))))))))))))))
)))))))))))))))))))))))))))))))))))))))))))))))))),                                                                    {          -))))))))))))))))))))))))))))))))))))))))))))))))))
)))))))))))))))))))))))))))))))))))))))))))))))))),                                                                               -))))))))))))))))))))))))))))))))))))))))))))))))))
)))))))))))))))))))))))))))))))))))))))))))))))))),                                                                               -))))))))))))))))))))))))))))))))))))))))))))))))))
)))))))))))))))))))))))))))))))))))))))))))))))))),                                                                               -))))))))))))))))))))))))))))))))))))))))))))))))))
)))))))))))))))))))))))))))))))))))))))))))))))))),                                                                               -))))))))))))))))))))))))))))))))))))))))))))))))))
)))))))))))))))))))))))))))))))))))))))))))))))))),                                                                               -))))))))))))))))))))))))))))))))))))))))))))))))))
)))))))))))))))))))))))))))))))))))))))))))))))))),                                                                               -))))))))))))))))))))))))))))))))))))))))))))))))))
)))))))))))))))))))))))))))))))))))))))))))))))))),                *                                                              -))))))))))))))))))))))))))))))))))))))))))))))))))
)))))))))))))))))))))))))))))))))))))))))))))))))),                                                                               -))))))))))))))))))))))))))))))))))))))))))))))))))
)))))))))))))))))))))))))))))))))))))))))))))))))),                                                                               -))))))))))))))))))))))))))))))))))))))))))))))))))
)))))))))))))))))))))))))))))))))))))))))))))))))),                                                                               -))))))))))))))))))))))))))))))))))))))))))))))))))
)))))))))))))))))))))))))))))))))))))))))))))))))),                                                                               -))))))))))))))))))))))))))))))))))))))))))))))))))
)))))))))))))))))))))))))))))))))))))))))))))))))),                                       (~                                      -))))))))))))))))))))))))))))))))))))))))))))))))))
)))))))))))))))))))))))))))))))))))))))))))))))))),                                                                               -))))))))))))))))))))))))))))))))))))))))))))))))))
)))))))))))))))))))))))))))))))))))))))))))))))))),                                                               _               -))))))))))))))))))))))))))))))))))))))))))))))))))
)))))))))))))))))))))))))))))))))))))))))))))))))),                                                                               -))))))))))))))))))))))))))))))))))))))))))))))))))
)))))))))))))))))))))))))))))))))))))))))))))))))),                                                                               -))))))))))))))))))))))))))))))))))))))))))))))))))
)))))))))))))))))))))))))))))))))))))))))))))))))),                                                                               -))))))))))))))))))))))))))))))))))))))))))))))))))
)))))))))))))))))))))))))))))))))))))))))))))))))),                                                                               -))))))))))))))))))))))))))))))))))))))))))))))))))
)))))))))))))))))))))))))))))))))))))))))))))))))),                                                                               -))))))))))))))))))))))))))))))))))))))))))))))))))
)))))))))))))))))))))))))))))))))))))))))))))))))),                                                                               -))))))))))))))))))))))))))))))))))))))))))))))))))
)))))))))))))))))))))))))))))))))))))))))))))))))),                                                                               -))))))))))))))))))))))))))))))))))))))))))))))))))
)))))))))))))))))))))))))))))))))))))))))))))))))),                    B                                                          -))))))))))))))))))))))))))))))))))))))))))))))))))
)))))))))))))))))))))))))))))))))))))))))))))))))),                                                                               -))))))))))))))))))))))))))))))))))))))))))))))))))
)))))))))))))))))))))))))))))))))))))))))))))))))),                                                                               -))))))))))))))))))))))))))))))))))))))))))))))))))
)))))))))))))))))))))))))))))))))))))))))))))))))),                                                                               -))))))))))))))))))))))))))))))))))))))))))))))))))
)))))))))))))))))))))))))))))))))))))))))))))))))),                                                                       {       -))))))))))))))))))))))))))))))))))))))))))))))))))
)))))))))))))))))))))))))))))))))))))))))))))))))),                                                                               -))))))))))))))))))))))))))))))))))))))))))))))))))
)))))))))))))))))))))))))))))))))))))))))))))))))),                                                                               -))))))))))))))))))))))))))))))))))))))))))))))))))
))))))))))))))))))))))))))))))))))))))))))))))))));<<<<<<<<<<<<<<<<<<<<<<<<<<<<<<<<<#            !<<<<<<<<<<<<<<<<<<<<<<<<<<<<<<<<=))))))))))))))))))))))))))))))))))))))))))))))))))
)))))))))))))))))))))))))))))))))))))))))))))))))))))))))))))))))))))))))))))))))))),            -)))))))))))))))))))))))))))))))))))))))))))))))))))))))))))))))))))))))))))))))))))
)))))))))))))))))))))))))))))))))))))))))))))))))))))))))))))))))))))))))))))))))))),            -)))))))))))))))))))))))))))))))))))))))))))))))))))))))))))))))))))))))))))))))))))
)))))))))))))))))))))))))))))))))))))))))))))))))))))))))))))))))))))))))))))))))))),            -)))))))))))))))))))))))))))))))))))))))))))))))))))))))))))))))))))))))))))))))))))
)))))))))))))))))))))))))))))))))))))))))))))))))))))))))))))))))))))))))))))))))))),            -)))))))))))))))))))))))))))))))))))))))))))))))))))))))))))))))))))))))))))))))))))
)))))))))))))))))))))))))))))))))))))))))))))))))))))))))))))))))))))))))))))))))))),            -)))))))))))))))))))))))))))))))))))))))))))))))))))))))))))))))))))))))))))))))))))
)))))))))))))))))))))))))))))))))))))))!""""""""""""""""""""""""""""""""""""""""""""=            ;""""""""""""""""""""""""""""""""""""""""""""#))))))))))))))))))))))))))))))))))))))
))))))))))))))))))))))))))))))))))))))),                                                                                                      -))))))))))))))))))))))))))))))))))))))
))))))))))))))))))))))))))))))))))))))),                                                                                                      -))))))))))))))))))))))))))))))))))))))
))))))))))))))))))))))))))))))))))))))),                                                                                                      -))))))))))))))))))))))))))))))))))))))
))))))))))))))))))))))))))))))))))))))),                                                                                                      -))))))))))))))))))))))))))))))))))))))
))))))))))))))))))))))))))))))))))))))),                            _                                                                         -))))))))))))))))))))))))))))))))))))))
))))))))))))))))))))))))))))))))))))))),                                                                                                      -))))))))))))))))))))))))))))))))))))))
))))))))))))))))))))))))))))))))))))))),            B                                                    B                                    -))))))))))))))))))))))))))))))))))))))
))))))))))))))))))))))))))))))))))))))),                                                                                                      -))))))))))))))))))))))))))))))))))))))
))))))))))))))))))))))))))))))))))))))),                                                                                                      -))))))))))))))))))))))))))))))))))))))
))))))))))))))))))))))))))))))))))))))),                                                                                        *             -))))))))))))))))))))))))))))))))))))))
))))))))))))))))))))))))))))))))))))))),                                                    {                                                 -))))))))))))))))))))))))))))))))))))))
))))))))))))))))))))))))))))))))))))))),                                B                                                                     -))))))))))))))))))))))))))))))))))))))
))))))))))))))))))))))))))))))))))))))),                                                                                                      -))))))))))))))))))))))))))))))))))))))
))))))))))))))))))))))))))))))))))))))),                  _                                                                                   -))))))))))))))))))))))))))))))))))))))
))))))))))))))))))))))))))))))))))))))),                                                       *                                              -))))))))))))))))))))))))))))))))))))))
))))))))))))))))))))))))))))))))))))))),                                                                                        B             -))))))))))))))))))))))))))))))))))))))
))))))))))))))))))))))))))))))))))))))),                                                                                                      -))))))))))))))))))))))))))))))))))))))
))))))))))))))))))))))))))))))))))))))),                     B                                                                                -))))))))))))))))))))))))))))))))))))))
))))))))))))))))))))))))))))))))))))))),                                                                                                      -))))))))))))))))))))))))))))))))))))))
))))))))))))))))))))))))))))))))))))))),                                                                                                      -))))))))))))))))))))))))))))))))))))))
))))))))))))))))))))))))))))))))))))))),                                                                                                      -))))))))))))))))))))))))))))))))))))))
))))))))))))))))))))))))))))))))))))))),                                                                                                      -))))))))))))))))))))))))))))))))))))))
)))))))))))))))))))))))))))))))))))))));<<<<<<<<<<<<<<<<<<<<<<<<<<<<<<<<<<<#                             !<<<<<<<<<<<<<<<<<<<<<<<<<<<<<<<<<<<<=))))))))))))))))))))))))))))))))))))))
))))))))))))))))))))))))))))))))))))))))))))))))))))))))))))))))))))))))))),                             -)))))))))))))))))))))))))))))))))))))))))))))))))))))))))))))))))))))))))))
))))))))))))))))))))))))))))))))))))))))))))))))))))))))))))))))))))))))))),                             -)))))))))))))))))))))))))))))))))))))))))))))))))))))))))))))))))))))))))))
))))))))))))))))))))))))))))))))))))))))))))))))))))))))))))))))))))))))))),                             -)))))))))))))))))))))))))))))))))))))))))))))))))))))))))))))))))))))))))))
))))))))))))))))))))))))))))))))))))))))))))))))))))))))))))))))))))))))))),                             -)))))))))))))))))))))))))))))))))))))))))))))))))))))))))))))))))))))))))))
))))))))))))))))))))))))))))))))))))))))))))))))))))))))))))))))))))))))))),                             -)))))))))))))))))))))))))))))))))))))))))))))))))))))))))))))))))))))))))))
))))))))))))))))))))))))))))))))))))))))))))))))))))))))))))))))))))!""""""=                             ;""""""#))))))))))))))))))))))))))))))))))))))))))))))))))))))))))))))))))))
)))))))))))))))))))))))))))))))))))))))))))))))))))))))))))))))))))),                                           -))))))))))))))))))))))))))))))))))))))))))))))))))))))))))))))))))))
)))))))))))))))))))))))))))))))))))))))))))))))))))))))))))))))))))),                                           -))))))))))))))))))))))))))))))))))))))))))))))))))))))))))))))))))))
)))))))))))))))))))))))))))))))))))))))))))))))))))))))))))))))))))),                                           -))))))))))))))))))))))))))))))))))))))))))))))))))))))))))))))))))))
)))))))))))))))))))))))))))))))))))))))))))))))))))))))))))))))))))),                                           -))))))))))))))))))))))))))))))))))))))))))))))))))))))))))))))))))))
)))))))))))))))))))))))))))))))))))))))))))))))))))))))))))))))))))),                      +                    -))))))))))))))))))))))))))))))))))))))))))))))))))))))))))))))))))))
)))))))))))))))))))))))))))))))))))))))))))))))))))))))))))))))))))),                                           -))))))))))))))))))))))))))))))))))))))))))))))))))))))))))))))))))))
)))))))))))))))))))))))))))))))))))))))))))))))))))))))))))))))))))),                                           -))))))))))))))))))))))))))))))))))))))))))))))))))))))))))))))))))))
)))))))))))))))))))))))))))))))))))))))))))))))))))))))))))))))))))),                      {                    -))))))))))))))))))))))))))))))))))))))))))))))))))))))))))))))))))))
)))))))))))))))))))))))))))))))))))))))))))))))))))))))))))))))))))),                                           -))))))))))))))))))))))))))))))))))))))))))))))))))))))))))))))))))))
))))))))))))))))))))))))))))))))))))))))))))))))))))))))))))))))))));<<<<<<<<<<<<<<<#            !<<<<<<<<<<<<<<=))))))))))))))))))))))))))))))))))))))))))))))))))))))))))))))))))))
))))))))))))))))))))))))))))))))))))))))))))))))))))))))))))))))))))))))))))))))))))=            ;)))))))))))))))))))))))))))))))))))))))))))))))))))))))))))))))))))))))))))))))))))
