16 17          $
#################
#@....#.....1...#
#.##.#.###.##.#.#
#....#...#....#.#
####.###.#.####.#
#....#...#....#.#
#.######.#.##.#.#
#......#.#....#.#
###.####.#.####.#
#..3....#.#..2#.#
#.######.#.##.#.#
#....#...#....#.#
####.#.###.####.#
#....#...#....#.#
#..&......#...#.#
#################
